15
15
..##.#.........
.##..#.........
##.##..........
#.##...........
..#............
##.............
...............
...............
...............
...............
...............
...............
...............
...............
...............